StudentID,Name,Maths,Science,English,History,Total
1,Aarav,85,80,78,72,315
2,Ishita,78,85,82,76,321
3,Rohan,92,88,89,85,354
4,Meera,65,60,70,68,263
5,Kiran,74,72,75,70,291
6,Dev,88,91,84,82,345
7,Sanya,90,86,87,80,343
8,Arjun,81,79,77,74,311
9,Priya,70,68,73,71,282
10,Neha,95,94,90,88,367
